

NO textures/candy1_250x250.png
SO textures/candy2_250x250.png
WE textures/candy3_250x250.png

EA textures/candy4_250x250.png
D textures/door_128x128.png




        1111111111111111111111111
        1000000000110000000000001
        10101100001110000000000001
        1001000000P000000000000E1
111111111011000001110000000000001
100000000011000001100111111111111
111111111111111111111111111111111
11111111111111111111111111111
11110111111111011101010010001
11110111111111011101010010001
11000000110101011100000110001
10000000000000001100000110001
100000000000000011010000100001
110000011101010111110111100111
11110111 1110101 101111010001
11111111 1111111 111111111111
