

NO          textures/einstein.png
SO textures/socrate.png
WE textures/epicure.png

EA  textures/voltaire.png



C               255,255,256
F   255,255,255


        1111111111111111111111111
        1000000000110000000000001
        10101100001110000000000001
        1001000000000000W000000001
1111111110110000011100000000000011
100000000011000001100011111111111
111111111111011111111001111111111
11111111111101111111100111111
11110111111100011101010010001
11110111111110011101010010001
11000000110100010000000110001
10000000000000001100000110001
100000000000000011010000100001
110000011101010111110111100111
11110111 1110101 101111010001
11111111 1111111 111111111111
